Mm, Mm, Mm, Mm, Mm, Ss, Mm, Mm, Mm, Mm, Mm, Mm, Mm, Mm, Mm, Mm, Mm, Mm, Mm, Mm, Mm, Mm, Mm, Mm, Wog, Wog, Wog, Wog, Wog, Wog, Wog, Wog, Wog, Wog, Wog, Wog, Wog, Wog, Wog, Wog, Wog, Wog, Wog, Wog, Wog, Wog, Wog, Wog, Wog, Wog, Wog, Wog, Wog, Wog, Wog^Bsb|, Wog, Wog, Wog, Wog, Wog, Wog, Wog, Wog, Wog, Wog, Wog, Wog, Wog, Wog, Wog
Mm, Mm, Hh, Mm, Mm, Mm, Mm, Mm, Mm, Mm, Mm, Mm, Mm, Mm, Mm, Mm, Mm, Mm, Mm, Mm, Mm, Mm, Mm, Mm, Wog, Wog, Wog, Wog, Wog, Wog, Wog, Wog, Wog, Wog, Wog, Wog, Wog, Wog, Wog, Wog, Wog, Wog, Wog, Wog, Wog, Wog, Wog, Wog, Wog, Wog, Wog, Wog, Wog, Wog, Wog^Bsb|, Wog, Wog, Wog, Wog, Wog, Wog, Wog, Wog, Wog, Wog, Wog, Wog, Wog, Wog, Wog
Mm, Hh, Hh^Vhh, Hh, Mm, Mm, Hh, Hh, Hh, Mm, Mm, Mm, Hh, Mm, Mm, Mm, Mm, Mm, Wog, Wog, Wog, Wog, Wog, Wog, Wog, Wog, Wog, Wog, Wog, Wog, Wog, Wog, Wog, Wog, Mm, Wog, Wog, Wog, Wog, Wog, Wog, Wog, Wog, Wog, Wog, Wog, Wog, Wog, Hh, Wog, Wog, Wog, Wog, Wog, Wog^Bsb|, Wog, Wog, Wog, Wog, Wog, Wog, Wog, Wog, Wog, Wog, Wog, Wog, Wog, Hh, Wog
Mm, Hh, Hh, Hh, Mm, Mm, Hh, Hh, Hh, Hh, Hh, Hh, Hh, Hh, Hh, Mm, Mm, Wog, Wog, Wog, Wog, Wog, Wog, Wog, Wog, Wog, Wog, Wog, Mm, Mm, Mm, Wog, Mm, Mm, Mm, Mm, Mm, Wog, Wog, Wog, Hh, Wog, Wog, Wog, Hh, Hh, Hh, Hh, Hh, Hh, Mm, Wog, Hh, Cud, Hh, Cud, Hh, Wog, Wog, Wog, Hh, Hh, Hh, Hh, Hh, Wog, Wog, Hh, Hh, Hh
Mm, Mm, Mm, Mm, Mm, Hh, Hh, Hh, Hh, Hh, Hh, Hh, Hh, Hh, Hh, Mm, Mm, Wog, Wog, Wog, Wog, Wog, Wog, Wog, Mm, Wog, Mm, Mm, Mm, Mm, Mm, Mm, Mm, Mm, Mm, Mm, Mm, Mm, Hh, Hh, Hh, Hh, Hh, Hh, Hh, Hh, Hh, Hh, Hh, Hh, Mm, Mm, Hh, Hh, Hh, Hh, Hh, Mm, Mm, Hh, Hh, Hh, Hh, Hh, Hh, Hh, Hh, Hh, Hh, Hh
Mm, Mm, Hh, Hh, Hh, Hh, Hh, Hh, Hh, Hh, Mm, Mm, Mm, Hh, Mm, Mm, Wog, Wog, Wog, Wog, Wog, Wog, Hh, Mm, Mm, Mm, Mm, Mm, Mm, Mm, Mm, Mm, Mm, Mm, Mm, Mm, Hh, Mm, Uu^Vud, Hh, Hh, Hh, Hh^Vhh, Hh, Hh, Hh, Hh, Hh, Hh, Mm, Mm, Mm, Mm, Hh, Hh, Hh, Mm, Mm, Mm, Hh, Hh, Hh, Hh, Hh, Hh, Hh, Hh, Hh, Hh, Hh
Mm, Mm, Hh, Hh, Hh, Mm, Mm, Mm, Mm, Mm, Mm, Mm, Mm, Mm, Mm, Mm, Wog, Wog, Wog, Wog, Wog, Hh, Hh, Mm, Mm, Mm, Mm, Mm, Mm, Mm, Mm, Mm, Mm, Mm, Mm, Hh, Hh, Hh, Rb, Rb, Rb, Hh, Rb, Hh, Hh, Hh, Uu^Vud, Hh, Hh, Hh, Hh, Mm, Mm, Hh, Hh, Hh, Hh, Mm, Mm, Hh, Hh, Hh, Hh, Hh, Hh, Hh, Hh, Hh, Hh, Hh
Mm, Mm, Mm, Hh, Mm, Mm, Mm, Mm, Mm, Mm, Mm, Mm, Mm, Mm, Mm, Mm, Wog, Wog, Wog, Wog, Wog, Hh, Hh, Hh, Hh, Mm, Mm, Mm, Mm, Mm, Mm, Mm, Mm, Mm, Mm, Hh, Hh, Hh, Uu^Vu, Ce, Hh, Rb, Hh, Rb, Rb, Hh, Rb, Hh, Hh, Hh, Hh, Mm, Mm, Hh, Hh, Hh, Hh, Mm, Mm, Hh, Hh, Hh, Hh, Hh, Hh, Hh, Hh, Hh, Hh, Hh
Mm, Mm, Hh, Hh, Hh, Mm, Hh, Hh, Hh, Mm, Mm, Mm, Mm, Mm, Wog, Wog, Wog, Wog, Wog, Wog, Ss, Ss, Hh, Hh, Hh, Hh, Hh, Hh, Hh, Hh, Hh, Mm, Mm, Mm, Mm, Mm, Mm, Hh, Mm, Hh, Hh, Ce, 2 Ce, Ce, Hh, Rb, Rb, Ce, Rb, Hh, Uu^Vud, Mm, Mm, Hh, Hh, Hh, Hh, Mm, Mm, Hh, Hh, Hh, Hh, Hh, Hh, Hh, Hh, Hh, Hh, Hh
Mm, Mm, Hh, Hh, Hh, Hh, Hh, Hh, Hh, Mm, Hh, Hh, Hh, Wog, Wog, Wog, Wog, Wog, Ss, Ss, Ss, Ss, Ss, Hh, Ss, Hh, Hh, Hh, Hh, Hh, Hh, Mm, Mm, Mm, Mm, Mm, Mm, Mm, Mm, Mm, Mm, Ce, Hh, Ce, Hh, Hh, Hh, Rb, Hh, Rb, Hh, Hh, Mm, Hh, Hh, Hh, Hh, Mm, Mm, Mm, Hh, Hh, Hh, Hh, Hh, Hh, Hh, Hh, Hh, Hh
Mm, Mm, Mm, Hh, Hh, Hh, Hh, Hh, Wog, Mm, Hh, Hh, Hh, Wog, Wog, Wog, Wog, Wog, Ss, Ss, Ss, Ss, Ss, Ss, Ss, Ss, Ss, Hh, Hh, Hh, Hh, Hh, Hh, Mm, Hh, Mm, Hh, Mm, Mm, Mm, Mm, Mm, Mm, Mm, Mm, Mm, Mm, Hh, Hh, Hh, Hh, Hh, Mm, Mm, Hh, Hh, Hh, Mm, Mm, Mm, Hh, Hh, Hh, Hh, Hh, Hh, Hh, Hh, Hh, Hh
Ss, Mm, Mm, Mm, Wog, Hh, Wog, Wog, Wog, Wog, Wog, Hh, Wog, Wog, Wog, Wog, Wog, Wog, Ss, Ss, Ss, Wwf, Ss, Ss, Wwf, Ss, Ss, Ss, Ss, Hh, Hh, Hh, Hh, Hh, Hh, Hh, Hh, Hh, Hh, Mm, Hh, Mm, Hh, Mm, Mm, Mm, Mm, Mm, Ce, Hh, Hh, Ce, Mm, Mm, Hh, Hh, Hh, Hh, Hh, Hh, Hh, Hh, Hh, Hh, Hh, Hh, Hh, Hh, Hh, Hh
Ss, Wog, Wog, Wog, Wog, Wog, Wog, Wog, Wog, Wog, Wog, Wog, Wog, Wog, Wog, Wog, Wog, Ss, Ss, Ss, Ss, Wwf, Ss, Ss, Wwf, Wwf, Ss, Ss, Ss, Ss, Ss, Ss, Ss, Hh, Hh, Hh, Hh, Hh, Hh, Hh, Hh, Hh, Hh, Hh, Hh, Mm, Mm, Mm, Hh, Hh, Sm, Hh, Hh, Hh, Hh, Hh, Ss, Hh, Hh, Hh, Hh, Hh, Hh, Hh, Hh, Hh, Ss, Hh, Ss, Ss
Ss, Wog, Wog, Wog, Wog, Wog, Wog, Wog, Wog, Wog, Wog, Wog, Wog, Wog, Wog, Wog, Wog, Ss, Ss, Ss, Wwf, Wwf, Wwf, Ss, Wwf, Ss, Ss, Ss, Ss, Ss, Ss, Ss, Ss, Ss, Ss, Ss, Ss, Ss, Ss, Ss, Ss, Hh, Hh, Hh, Hh, Hh, Hh, Hh, Hh, Hh, Hh, Sm, Sm, Ss, Sm, Ss, Ss, Ss, Ss, Ss, Ss, Ss, Ss, Ss, Ss, Ss, Ss, Ss, Ss, Ss
Ss, Ss, Ss, Wog, Wog, Wog, Wog, Wog, Wog, Wog, Wog, Wog, Wog, Wog, Wog, Wog, Ss, Ss, Ss, Ss, Ss, Ss, Ss, Ss, Ss, Ss, Ss, Ss, Ss, Ss, Ss, Ss, Wwf, Ss, Ss, Ss, Ss, Ss, Ss, Ss, Ss^Vhs, Ss, Ss, Ss, Ss, Hh, Hh, Hh, Sm, Hh, Ss, Ss, Ss, Ss, Ss, Sm, Ss, Ss, Ss, Ss, Wwf, Ss, Ss, Wwf, Ss, Ss, Wwf, Wwf, Ss, Ss
Wog, Wog, Wog, Ss, Ss, Wog, Wog, Wog, Wog, Wog, Wog, Wog, Wog, Wog, Ss, Ss, Ss, Ss, Wwf, Ss, Wwf, Ss, Ss, Ss, Wwf, Ss, Ss, Ss, Wwf, Ss, Ss, Ss, Wwf, Ss, Ss, Wwf, Ss, Ss, Ss, Ss, Ss, Ss, Ss, Ss, Ss, Ss, Ss, Ss, Ss, Ss, Wwf, Ss, Ss, Ss, Ss, Ss, Sm, Ss, Ss, Ss, Ss, Ss, Ss, Wwf, Ss, Ss, Ss, Ss, Ss, Ss
Wog, Wog, Wog, Ss, Ss, Wog, Ss, Wog, Wog, Wog, Ss, Ss, Ss, Ss, Ss, Ss, Ss, Wwf, Wwf, Ss, Ss, Ss, Ss, Ss, Ss, Ss, Ss, Ss, Ss, Ss, Ss, Ss, Ss, Wwf, Ss, Wwf, Ss, Ss, Ss, Ss, Ss, Ss, Ss, Sm, Ss, Ss, Ss, Ss, Ss, Ss, Ss, Ss, Ss, Ss, Wwf, Ss, Ss, Ss, Sm, Ss, Ss, Ss, Wwf, Ss, Wwf, Wwf, Ss, Ss, Ss, Ss
Wog, Wog, Wog, Ss, Ss, Ss, Ss, Ss, Ss, Ss, Ss, Wwf, Wwf, Wwf, Ss, Ss, Ss, Ss, Ss, Wwf, Ss, Ss, Wwf, Ss, Gs^Vht, Wwf, Ss, Ss, Ss, Ss, Ss, Ss, Ss, Ss, Ss, Ss, Ss, Wwf, Ss, Sm, Ss, Ss, Ss, Ss, Ss, Ss, Ss, Ss, Ss, Ss, Ss, Ss, Ss, Wwf, Ss, Ss, Ss, Ss, Sm, Ss, Ss, Ss, Wwf, Ss, Ss, Ss, Ss, Wwf, Wwf, Ss
Wog, Wog, Wog, Ss, Wog, Wog, Wog, Ss, Ss, Ss, Wwf, Ss, Ss, Wwf, Ss, Ss, Ss, Ss, Wwf, Ss, Ss, Ss, Wwf, Wwf, Ss, Ss, Ss, Ss, Ss, Ss, Ss, Ss, Ss, Ss, Ss, Ss, Ss, Sm, Ss, Ss, Ss, Ss, Ss, Ss, Ss, Ss, Wwf, Wwf, Ss, Wwf, Ss, Ss, Wwf, Ss, Wwf, Ss, Ss, Ss, Ss, Ss, Ss, Ss, Ss, Wwf, Ss, Ss, Ss, Ss, Ss, Ss
Wog, Wog, Wog, Wog, Wog, Wog, Wog, Ss, Ss, Ss, Ss, Ss, Ss, Ss, Wwf, Ss, Wwf, Ss, Ss, Ss, Wwf, Ss, Ss, Ss, Ss, Ss, Ss, Ss, Ss, Sm, Ss, Sm, Ss, Sm, Sm, Sm, Ss, Ss, Ss, Ss, Ss, Ss, Ss, Ss, Wwf, Ss, Ss, Ss, Wwf, Ss, Ss, Ss, Ss, Ss, Ss, Wwf, Ss, Ss, Ss, Ss, Wwf, Ss, Ss, Ss, Wwf, Ss, Ss, Wwf, Ss, Ss
Wog, Wog, Wog, Wog, Wog, Wog, Wog, Wog, Ss, Ss, Ss, Ss, Ss, Wwf, Ss, Ss, Ss, Ss, Ss, Ss, Ss, Ss, Wwf, Ss, Ss, Ss, Ss, Sm, Ss, Ss, Ss, Ss, Ss, Ss, Ss, Ss, Ss, Ss, Ss, Ss, Ss, Ss, Ss, Ss, Ss, Ss, Wwf, Wwf, Ss, Ss, Ss, Ss, Ss, Wwf, Ss, Ss, Wwf, Wwf, Ss, Wwf, Ss, Wwf, Ss, Wwf, Wwf, Ss, Wwf, Ss, Ss, Ss
Wog, Wog, Wog, Wog, Wog, Wog, Wog, Wog, Wog, Ss, Ss, Ss, Ss, Ss, Ss, Ss, Ss, Ss, Ss, Ss, Ss, Ss, Ss, Wwf, Ss, Ss, Sm, Ss, Ss, Ss, Ss, Ss, Wwf, Ss, Ss, Ss, Ss, Ss, Ss, Ss, Ss, Ss, Wwf, Ss, Ss, Ss, Wwf, Ss, Wwf, Ss, Ss, Ss, Ss, Ss, Ss, Ss, Ss, Wwf, Sm, Ss, Ss, Wwf, Ss, Ss, Ss, Ss, Ss, Ss, Wwf, Ss
Wog, Wog, Wog, Wog, Wog, Wog, Wog, Wog, Wog, Wog, Ss, Ss, Wwf, Ss, Ss, Wwf, Ss, Ss, Ss, Ss, Ss, Wwf, Ss, Ss, Sm, Sm, Ss, Ss, Ss, Wwf, Ss, Ss, Ss, Ss, Ss, Wwf, Ss, Ss^Vhs, Ss, Wwf, Wwf, Ss, Ss, Ss, Ss, Ss, Ss, Ss, Ss, Ss, Ss, Ss, Gs^Vht, Ss, Wwf, Wwf, Ss, Ss, Sm, Ss, Ss, Ss, Ss, Wwf, Ss, Ss, Ss, Wwf, Ss, Ss
Wog, Wog, Wog, Wog, Wog, Wog, Wog, Wog, Wog, Wog, Ss, Ss, Wwf, Wwf, Ss, Wwf, Ss, Ss, Wwf, Ss, Wwf, Ss, Ss, Ss, Sm, Ss, Sm, Ss, Ss, Ss, Wwf, Wwf, Ss, Ss, Ss, Ss, Ss, Wwf, Ss, Ss, Wwf, Wwf, Wwf, Ss, Ss, Ss, Ss, Ss, Ss, Wwf, Wwf, Wwf, Ss, Ss, Ss, Ss, Ss, Ss, Ss, Ss, Wwf, Ss, Ss, Ss, Ss, Ss, Ss, Ss, Ss, Ss
Wog, Wog, Wog, Wog, Wog, Wog, Wog, Wog, Wog, Wog, Ss, Wwf, Wwf, Ss, Ss, Ss, Ss, Wwf, Ss, Ss, Ss, Ss, Ss, Ss, Wwf, Ss, Ss, Ss, Ss, Ss, Wwf, Ss, Wwf, Wwf, Ss, Ss, Ss, Wwf, Ss, Ss, Ss, Ss, Ss, Ss, Ss, Ss, Wwf, Wwf, Ss, Wwf, Ss, Ss, Ss, Ss, Ss, Ss, Ss, Ss, Sm, Ss, Wwf, Ss, Ss, Ss, Ss, Ss, Ss, Ss, Ss, Ss
Wog, Wog, Wog, Wog, Wog, Wog, Wog, Wog, Wog, Ss, Ss, Ss, Ss, Ss, Ss, Wwf, Ss, Wwf, Ss, Ss, Ss, Ss, Ss, Wwf, Ss, Ss, Wwf, Ss, Sm, Ss, Sm, Wwf, Ss, Wwf, Wwf, Ss, Ss, Wwf, Ss, Wwf, Wwf, Ss, Ss, Ss, Ss, Ss, Wwf, Ss, Ss, Ss, Ss, Ss, Wwf, Ss, Ss, Ss, Ss, Wwf, Ss, Ss, Wwf, Ss, Wwf, Ss, Wwf, Ss, Wwf, Wwf, Ss, Ss
Wog, Wog, Wog, Wog, Wog, Wog, Wog, Wog, Wog, Wog, Wog, Ss, Ss, Wwf, Ss, Ss, Wwf, Wwf, Wwf, Ss, Ss, Ss, Ss, Wwf, Ss, Ss, Ss, Ss, Wwf, Ss, Wwf, Ss, Sm, Ss, Wwf, Ss, Ss, Ss, Ss, Ss, Ss, Wwf, Ss, Ss, Ss, Ss, Ss, Ss, Ss, Wwf, Wwf, Ss, Ss, Ss, Ss, Ss, Ss, Wwf, Wwf, Wwf, Sm, Wwf, Ss, Ss, Ss, Ss, Ss, Ss, Ss, Ss
Wog, Wog, Wog, Wog, Wog, Wog, Wog, Wog, Wog, Wog, Wog, Ss, Wwf, Ss, Ss, Wwf, Wwf, Ss, Ss, Ss, Wwf, Ss, Ss, Wwf, Ss, Ss, Ss, Ss, Ss^Vhs, Wwf, Wwf, Ss, Sm, Ss, Wwf, Wwf, Ss, Ss, Ss, Ss, Ss, Wwf, Ss, Ss, Wwf, Ss, Ss, Ss, Wwf, Wwf, Wwf, Ss, Ss, Ss, Ss, Ss, Ss, Wwf, Wwf, Ss, Ss, Ss, Ss, Ss, Ss, Wwf, Ss, Ss, Ss, Ss
Wog, Wog, Wog, Wog, Wog, Wog, Wog, Wog, Wog, Wog, Wog, Ss, Ss, Ss, Ss, Ss, Ss, Ss, Ss, Ss, Wwf, Wwf, Wwf, Wwf, Ss, Ss, Ss, Wwf, Ss, Wwf, Ss, Ss, Ss, Ss, Ss, Ss, Ss, Ss, Wwf, Wwf, Wwf, Ss, Ss, Wwf, Ss, Ss, Wwf, Ss, Ss, Wwf, Ss, Ss, Ss, Wwf, Ss, Ss, Wwf, Wwf, Ss, Ss, Wwf^Bw/, Sm, Ss, Ss, Wwf, Wwf, Ss, Ss, Ss, Ss
Wog, Wog, Wog, Wog, Wog, Wog, Wog, Wog, Wog, Wog, Ss, Ss, Ss, Wwf, Ss, Wwf, Ss, Ss, Wwf, Wwf, Wwf, Ss, Wwf, Ss, Ss, Ss, Ss, Ss, Ss, Ss, Wwf, Ss, Ss, Ss, Ss, Ss, Ss, Ss, Wwf, Wwf, Wwf, Ss, Ss, Ss, Ss, Ss, Ss, Ss, Ss, Ss, Ss, Ss, Ss, Ss, Ss, Ss, Sm, Ss, Ss, Sm, Sm, Ss, Ss, Ss, Wwf, Ss, Ss, Ss, Ss, Ss
Wog, Wog, Wog, Wog, Wog, Wog, Ss, Ss, Ss, Ss, Ss, Ss, Ss, Ss, Ss, Ss, Wwf, Wwf, Wwf, Ss, Ss, Ss, Ss, Ss, Ss, Ss, Ss, Ss, Ss, Ss, Ss, Wwf, Sm, Sm, Ss, Ss, Sm, Ss, Ss, Wwf, Ss, Ss, Ss, Ss, Wwf, Ss, Sm, Ss, Sm, Sm, Ss, Sm, Ss, Ss, Ss, Ss, Ss, Ss, Ss, Ss, Wwf, Wwf, Ss, Ss, Wwf, Ss, Wwf, Ss, Ss, Ss
Wog, Wog, Wog, Wog, Wog, Wog, Wog, Wog, Wog, Ss, Ss, Ss, Wwf, Ss, Ss, Ss, Ss, Wwf, Wwf, Ss, Wwf, Ss, Ss, Ss, Sm, Ss, Sm, Sm, Sm, Ss, Ss, Wwf^Bw/r, Ss, Sm, Ss, Sm, Ss, Sm, Ss, Wwf, Ss, Ss, Sm, Ss, Wwf, Ss, Ss, Ss, Ss, Ss, Ss, Ss, Ss, Ss, Ss, Wwf, Ss, Ss, Wwf, Wwf, Wwf, Sm, Ss, Ss, Ss, Wwf, Wwf, Ss, Ss, Ss
Wog, Wog, Wog, Wog, Wog, Wog, Wog, Wog, Wog, Wog, Ss, Ss, Ss, Ss, Ss, Ss, Ss, Ss, Wwf, Wwf, Ss, Wwf, Wwf, Ss, Sm, Sm, Wwf, Ss, Ss, Sm, Wwf, Ss, Ss, Ss, Ss, Ss, Ss, Ss, Wwf, Ss, Ss, Ss, Ss, Ss, Chs, Wwf, Ss, Wwf, Ss, Ss, Ss, Ss, Ss, Wwf, Ss, Ss, Ss, Wwf, Ss, Wwf, Ss, Ss, Sm, Ss, Ss, Ss, Ss, Ss, Ss, Ss
Wog, Wog, Wog, Wog, Wog, Wog, Wog, Wog, Wog, Wog, Ss, Ss, Ss, Ss, Ss, Ss, Wwf, Wwf, Ss, Ss, Ss, Ss, Ss, Wwf, Wwf, Ww, Ss, Wwf, Wwf, Wwf, Ss, Ss, Ss, Ss, Ss, Ss, Ss, Wwf, Wwf, Ss, Ss, Ss, Ss, Ss, Wwf, Wwf, Ss, Ss, Ss, Ss, Ss, Ss^Vhs, Ss, Ss, Wwf, Ss, Ss, Ss, Wwf, Wwf, Ss, Ss, Sm, Ss, Ss, Wwf, Wwf, Ss, Ss, Ss
Wog, Wog, Wog, Wog, Wog, Wog, Wog, Wog, Wog, Wog, Ss, Ss, Ss, Ss, Wwf, Wwf, Wwf, Wwf, Ss, Ss, Sm, Sm, Sm, Sm, Wwf, Ss, Ss, Wwf, Wwf, Wwf, Ss, Ss, Ss, Wwf, Ss, Ss, Wwf, Ss, Wwf, Wwf, Ss, Wwf, Wwf, Ss, Ss, Ss, Wwf, Ss, Ss, Ss, Wwf, Ss, Ss, Ss, Ss, Ss, Ss, Ss, Wwf, Ss, Ss, Ss, Ss, Sm, Sm, Ss, Wwf, Ss, Ss, Ss
Wog, Wog, Wog, Wog, Wog, Wog, Wog, Wog, Wog, Ss, Wog, Ss, Wog, Wog, Ss, Wwf, Ss, Ss, Rp, Sm, Sm, Sm, Ss, Wwf, Ss, Wwf, Ss, Wwf, Wwf, Ss, Wwf, Ss, Ss, Ss, Wwf, Ss, Ss, Wwf, Ss, Ss, Ss, Ss, Wwf, Wwf, Ss, Ss, Ss, Ss, Ss, Ss, Ss, Ss, Ss, Ss, Ss, Ss, Wwf, Wwf, Ss, Ss, Ss, Ss, Wwf, Ss, Sm, Ss, Ss, Ss, Ss, Ss
Wog, Wog, Wog, Wog, Wog, Wog, Wog, Wog, Wog, Wog, Ch, Wog, Wog, Wog, Wog, Ss, Wog^Bsb/, Wog^Bsb/, Wog^Bsb/, Rp, Ss, Ss, Wog, Ss, Wog, Ss, Wog, Ss, Ss, Ss, Ss, Wwf, Ss, Wwf, Ss, Wwf, Wwf, Ss, Ss^Vhs, Ss, Ss, Ss, Ss, Ss, Wwf, Ss, Ss, Ss, Ss, Wwf, Wwf, Ss, Ss, Ss, Wwf, Ss, Wwf, Wwf, Ss, Ss, Ss, Ss, Ss, Ss, Ss, Sm, Sm, Ss, Ss, Ss
Wog, Wog, Wog, Wog, Wog, Wog, Wog, Wog, Sm, Ss, Gs, Ch, Ch, Wog, Wo^Bsb/, Wo^Bsb/, Wo^Bsb/, Wog^Bsb/, Wog, Wog, Wog, Wog, Wog, Wog, Wog, Wog, Ss, Ss, Ss, Ss, Ss, Ss, Ss, Ss, Ss, Ss, Ss, Wwf, Ss, Ss, Ss, Ss, Wwf, Wwf, Ss, Wwf, Wwf, Ss, Ss, Wwf, Ss, Ss, Ss, Ss, Ss, Ss, Ss, Ss, Ss, Ss, Ss, Ss, Ss, Ss, Ss, Ss, Ss, Sm, Ss, Ss
Wog, Wog, Wog, Wog, Wog, Wog, Sm, Ss^Vhs, Sm, Ss, Rp, Gs, Rp, Rp, Rp, Wo^Bsb/, Sm, Wog, Wog, Wog, Wog, Wog, Wog, Wog, Wog, Wog, Ss, Ss, Ss, Ss, Wwf, Ss, Ss, Ss, Wwf, Ss, Wwf, Wwf, Ss, Ss, Wwf, Ss, Ss, Ss, Ss, Wwf, Ss, Ss, Ss, Ss, Ss, Ss, Ss, Wwf, Ss, Ss, Ss, Wwf, Ss, Wwf, Ss, Ss, Ss, Wwf, Ss, Ss, Ss, Ss, Sm, Ss
Wog, Wog, Wog, Wog, Wog, Wog, Wog, Ss, Ss, Rp, Ch, Rp, Ch, Rp, Gs, Ch, Ch, Wog, Wog, Wog, Wog, Wog, Wog, Wog, Wog, Wog, Ss, Ss, Ss, Ss, Ss, Wwf, Wwf, Ss, Ss, Ss, Ss, Ss, Ss^Dr, Ss, Ss, Ss, Ss, Wwf, Wwf, Ss, Ss, Ss, Ss, Ss, Ss, Ss, Ss, Ss, Ss, Ss, Ss, Wwf, Ss, Wwf, Ss, Ss, Ss, Wwf, Wwf, Ss, Wwf, Ss, Ss, Sm
Wog, Wog, Wog, Wog, Wog, Wog, Wog, Gs, Gs, Rp, Ch, 1 Kh, Ch, Rp, Rp, Gs, Gs, Ch, Wog, Wog, Wog, Wog, Wog, Wog, Wog, Ss, Ss, Ss, Wwf, Ss, Ss, Ss, Ss, Wwf, Wwf, Wwf, Gll^Ftr, Ss, Ss, Wwf, Ss, Ss, Ss, Ss, Ss, Ss, Ss, Wwf, Wwf, Ss, Ss, Wwf, Ss, Wwf, Ss, Ss, Ss, Wwf, Ss, Ss, Ss, Ss, Wwf, Ss, Ss, Ss, Ss, Ss, Ss, Ss
Wog, Wog, Wog, Wog, Wog^Bw\, Wog, Wog^Bw/, Gs, Gs, Rp, Rr^Vhc, Ch, Rp, Rp, Re, Gs, Ch, Ch, Wog, Wog, Wog, Wog, Wog, Wog, Wog, Ss, Ss, Ss, Ss, Ss, Ss, Ss, Wwf, Ss, Ss, Ss, Ss, Ss, Ss, Ss, Wwf, Ss, Wwf, Ss, Gll^Ftr, Ss, Ss, Ss, Wwf, Wwf, Ss, Ss, Wwf, Ss, Wwf, Wwf, Wwf, Ss, Ss, Ss, Ss, Ss, Ss, Ss, Ss, Ss, Wwf, Wwf, Ss, Ss
Wog, Wog, Wog, Wog^Bw/, Wog, Wog^Bw/, Wog, Gs^Bw\r, Gs^Bw\r, Rp, Rp, Rp, Gs, Gs, Re, Gs^Vh, Wog, Wog, Wog, Wog, Wog, Wog, Wog, Wog, Wog, Ss, Ss, Ss, Wwf, Ss, Wwf, Ss, Ss, Ss, Wwf, Ss, Ss, Gll^Ftr, Ss, Wwf, Wwf, Gll^Ftr, Ss, Ss, Gll^Ftr, Ss, Ss, Ss, Wwf, Wwf, Ss, Ss, Ss, Wwf, Ss, Wwf, Ss, Ss, Wwf, Wwf, Wwf, Ss, Wwf, Wwf, Wwf, Ss, Ss, Ss, Ss, Ss
Wog, Wog, Wog, Wog, Wog, Wog, Wog, Wog, Wog^Bw/, Gs^Bw\, Re, Gs^Vh, Re, Re, Wog, Wog, Wog, Wog, Wog, Wog, Wog, Wog, Wog, Wog, Wog, Wog, Ss, Ss, Ss, Ss, Ss, Ss, Ss, Wwf, Ss, Ss, Ss, Gll^Ftr, Ss, Ss, Ss, Ss, Ss, Ss, Ss, Ss, Ss, Wwf, Wwf, Ss, Ss, Ss, Wwf, Ss, Ss, Wwf, Wwf, Ss, Wwf, Ss, Wwf, Ss, Ss, Ss, Ss, Wwf, Wwf, Ss, Ss, Ss
Wog, Wog, Wog, Wog, Wog, Wog^Bw\, Wog^Bw/, Wog^Bw/, Wog, Wog, Wog, Re, Wog, Wog, Wog, Wog, Wog, Wog, Wog, Wog, Wog, Wog, Wog, Wog, Ss, Ss, Ss, Ss, Ss, Ss, Wwf, Ss, Wwf, Ss, Ss, Ss, Wwf, Ss, Ss, Ss, Gll^Ftr, Wwf, Gll^Ftr, Ss, Ss, Ss, Wwf, Wwf, Ss, Ss, Wwf, Ss, Ss, Ss, Wwf, Ss, Ss, Ss, Ss, Ss, Wwf, Wwf, Ss, Ss, Ss, Wwf, Ss, Wwf, Ss, Ss
Wog, Wog, Wog, Wog, Wog, Wog, Wog, Wog, Wog, Wog, Wog, Wog, Wog, Wog, Wog, Wog, Wog, Wog, Wog, Wog, Ss, Ss, Ss, Ss, Ss, Ss, Ss, Ss, Ss, Wwf, Wwf, Wwf, Wwf, Ss, Ss, Ss, Ss, Ss, Gll^Ftr, Ss, Ss, Gll^Ftr, Ss, Ss, Ss, Ss, Ss, Ss, Ss, Ss, Ss, Ss, Wwf, Ss, Ss, Ss, Wwf, Ss, Wwf, Ss, Ss, Ss, Ss, Ss, Ss, Ss, Ss, Ss, Ss, Ss
Wog, Wog, Wog, Wog, Wog, Wog, Wog, Wog, Wog, Wog, Wog, Wog, Wog, Wog, Wog, Wog, Wog, Wog, Wog, Wog, Ss, Ss, Ss, Ss, Ss, Ss, Ss, Ss, Ss, Ss, Ss, Ss, Ss, Ss, Ss, Ss, Ss, Ss, Ss, Ss, Ss, Ss, Gg, Wwf, Gg, Ss, Gg, Ss, Ss, Ss, Gg, Ss, Ss, Ss, Ss, Ss, Ss, Ss, Wwf, Ss, Ss, Ss, Wwf, Ss, Ss, Ss, Ss, Ss, Ss, Ss
