Ww, Ww, Ww, Mm, Mm, Mm, Mm, Mm, Mm, Ww, Ww, Ww, Ww, Ww, Ww, Ww, Ww, Ww, Ai, Mm, Mm, Ww, Mm, Mm, Mm, Mm, Mm, Mm, Mm, Mm, Mm, Mm, Mm, Ww, Rr, Rr, Mm, Gll^Fmf, Mm, Mm, Mm, Mm, Mm, Mm, Mm
Ww, Ww, Ww, Ww, Mm, Mm, Mm, Mm, Mm, Mm, Ww, Ww, Mm, Mm, Mm, Ww, Ww, Ww, Ai, Ai, Mm, Mm, Mm, Mm, Mm, Mm, Mm, Mm, Mm, Mm, Mm, Mm, Mm, Rr, Mm, Mm, Mm, Mm, Mm, Mm, Mm, Mm, Mm, Mm, Mm
Ww, Ww, Ww, Ww, Hh, Mm, Mm, Mm, Mm, Chr, Ww, Chr, Mm, Mm, Mm, Mm, Mm, Mm, Mm, Mm, Mm, Mm, Mm, Mm, Mm, Mm, Mm, Mm, Mm, Mm, Mm, Mm, Gll^Fmf, Rr, Mm, Mm, Mm, Mm, Mm, Mm, Gll^Fmf, Mm, Gll^Fmf, Mm, Gll^Fmf
Ww, Ww, Hh^Vhh, Ww, Hh, Hh, Hh, Hh, Mm, Mm, Mm, Ww, Ww, Mm, Mm, Mm, Mm, Mm, Mm, Mm, Mm, Mm, Hh, Ww, Ww, Ww, Ww^Vm, Ww, Ww, Hh, Hh, Hh, Gll^Fmf, Rr, Gg, Mm, Gll^Fmf, Mm, Gll^Fmf, Gll^Fmf, Gll^Fmf, Gg, Gg, Gll^Fmf, Gll^Fmf
Hh, Ww, Ww, Ww, Hh, Hh, Hh, Hh, Hh, Hh, Hh, Ww, Hh, Mm, Mm, Mm, Mm, Mm, Mm, Mm, Mm, Hh, Hh, Hh, Hh, Ww, Ww, Ww, Ww, Hh, Gll^Fmf, Gll^Fmf, Ww^Vm, Rr, Gg, Gg, Gll^Fmf, Gll^Fmf, Gll^Fmf, Gll^Fmf, Gll^Fmf, Gg, Gg, Gg, Gll^Fmf
Hh, Hh, Ww, Hh, Hh, Hh, Hh, Hh, Hh, Hh, Hh, Ww, Hh, Hh, Mm, Mm, Mm, Mm, Ai, Ww, Ww, Ww, Ww, Hh, Ww, Ww, Ww, Ww, Ww, Ww, Kme, Gll^Fmf, Ww, Rr, Gll^Fmf, Gll^Fmf, Gll^Fmf, Gll^Fmf, Gll^Fmf, Gll^Fmf, Gll^Fmf, Gll^Fmf, Gg, Gg, Gg
Ww, Ww, Hh, Ww, Hh, Hh, Hh, Hh, Hh, Hh, Hh, Ww, Ww^Vm, Hh, Mm, Mm, Mm, Mm, Ai, Ww, Ww, Ww, Ww, Hh, Ww, Ww, Ww, Ww, Ww, Ww, Gll^Fmf, Kme, Cme, Rr, Gll^Fmf, Gll^Fmf, Gg, Gg, Gg, Gg, Gll^Fmf, Gll^Fmf, Gll^Fmf, Gll^Fmf, Rr
Ww, Ww, Ww, Ww, Ww, Hh, Hh, Hh, Hh, Hh, Hh, Ww, Ww, Hh, Hh, Hh, Hh, Hh, Ww, Ww, Ww, Ww, Ww, Hh, Ww, Ww, Ww, Ww, Gll^Fmf, Ww, Gll^Fmf, Gll^Fmf, Rr, Kme, Kme, Gll^Fmf, Gg, Gg, Ww, Gg, Gg, Gll^Fmf, Gll^Fmf, Gg^Vh, Rr
Ww, Ww, Ww, Ww, Hh, Hh, Hh, Hh, Hh, Hh, Hh, Hh, Hh, Ww, Ww, Ww, Hh, Hh, Ww^Vm, Ww, Ww, Ww, Ww, Hh, Ww, Ww, Ww, Ww, Ww, Gll^Fmf, Gll^Fmf, Gll^Fmf, Rr, Gll^Fmf, Gll^Fmf, Ww, Ww, Ww, Ww^Vm, Ww, Gg, Gll^Fmf, Rr, Rr, Gg
Ww, Ww, Ww, Ww, Gg, Gg, Gg, Gg, Gg, Gg, Hh, Hh, Hh, Hh, Hh, Ww, Ww, Hh, Ww, Ww, Ww, Ww, Ww, Hh, Hh, Hh, Ww, Ww, Ww, Ww, Ww, Gg, Rr, Gg, Gll^Fmf, Gll^Fmf, Rr, Ww, Gll^Fmf, Ww, Gll^Fmf, Gll^Fmf, Rr, Gg, Gg
Ww, Ww, Ce, Gg, Ce, Gll^Fmf, Gll^Fmf, Gg, Gg, Gg, Hh, Gg, Hh, Hh, Hh, Hh, Ww, Hh, Hh, Ww, Ww, Hh, Hh, Gg, Ww, Ww, Gll^Fmf, Gll^Fmf, Gll^Fmf, Ww, Rr, Rr, Gg, Rr, Rr, Rr, Ww, Rr, Rr, Cme, Rr, Rr, Gg, Gg, Gg
Ww, Ww, Ce, 1 Ket, Ce, Rr, Rr, Gg, Gg, Gg, Gg, Gg, Gg, Gll^Fmf, Gll^Fmf, Ww, Ww, Hh, Ww, Ww, Ww, Gll^Fmf, Gll^Fmf, Gll^Fmf, Ww, Ww, Gll^Fmf, Gll^Fmf, Rr, Ww^Bw/, Ww, Ww, Ww, Gg, Rr, Ww, Ai, Ai, Ai, Ww, Gg, Gg, Gg, Gg, Gg
Ww, Ww, Gll^Fmf, Gll^Fmf, Gll^Fmf, Gg, Gll^Fmf, Rr, Rr, Gg, Gg, Gg, Gg, Gg, Gg, Gll^Fmf, Ww, Gll^Fmf, Ww, Ww, Ww, Ww, Ww, Ww, Gll^Fmf, Gll^Fmf, Rr, Rr, Gll^Fmf, Ww, Gll^Fmf, Ww, Ww^Vm, Gg, Rr, Ww, Ai, Ai, Ai, Aa, Gg, Gg, Gg, Gg, Gll^Fmf
Gg, Ww, Ww, Ww, Ww, Gg, Gg, Gll^Fmf, Gg, Rr, Rr, Gg, Rr, Gg, Rr, Gg, Ww, Gll^Fmf, Rr, Gll^Fmf, Rr, Rr, Rr, Ww^Vm, Rr, Rr, Gg, Gg, Gll^Fmf, Gll^Fmf, Gll^Fmf, Ww, Gg, Gg, Rr, Ww, Ai, Ai, Aa, Aa, Gg, Gg, Gg, Gll^Fmf, Gll^Fmf
Gg, Gll^Fmf, Gg, Gg, Ww, Ww, Ww, Ww, Ww, Ww, Gg^Vh, Rr, Gg, Rr, Gg, Rr, Rr, Ww^Bw/, Ww, Rr, Gg, Gll^Fmf, Gg, Rr, Gll^Fmf, Gg, Gg, Gg, Gg, Gll^Fmf, Gg, Ww, Gg, Rr, Gg, Gg, Aa, Ai, Aa, Aa, Gg, Gg, Gg, Gg, Gll^Fmf
Gg, Gll^Fmf, Gg, Gg, Ww, Ww, Gg, Ww, Ww, Ww, Gll^Fmf, Gll^Fmf, Gll^Fmf, Gg, Gg, Gg, Gll^Fmf, Gll^Fmf, Ww, Ww, Gg, Gg, Gg, Gg, Gg, Gll^Fmf, Gg, Gg, Gg, Gg, Gg, Ww, Rr, Rr, Ww, Gg, Ai, Ai, Aa, Aa, Gg, Gg, Gg, Gg, Gg