Ms, Ms, Ms, Ms, Ms, Ai, Ai, Ai, Ai, Ms^Xm, Ai, Ai, Ai, Ai, Aa^Fda, Ww, Ai, Ms^Xm, Ms, Ms, Ms, Ms, Ms, Ms, Ms, Ms, Ms^Xm, Ms^Xm, Ms^Xm, Ms^Xm, Xu, Xu, Xu, Ms^Xm, Ms^Xm, Ms^Xm, Xuc, Ur^Br|, Xuc, Ms, Ms, Ms
Ms, Ms, Ms, Ms, Ms, Ms, Rrc^Vhca, Ai, Aa^Fda, Ai, Ai, Ai, Ai, Ai, Ai, Ai, Aa^Fda, Aa^Fda, Ms, Ms, Ms, Ms, Ms, Ms, Ms^Xm, Ms^Xm, Ms^Xm, Ms^Xm, Xu, Xu, Urb, Urb, Urb, Xu, Xu, Ms^Xm, Xuc, Ur^Br|, Xuc, Ms^Xm, Ms^Xm, Ms
Ms, Ms, Ms, Ms, Ms, Ms, Aa^Fda, Aa^Fda, Ms, Ms, Ms, Ai, Ai^Bw/, Aa, Aa^Fda, Aa^Vea, Ms, Ms, Ms, Ms, Ms, Ms, Ms, Ms, Ms^Xm, Ms^Xm, Xu, Xu, Urb, Urb, Uu^Vud, Ql, Uu^Vud, Urb, Urb, Xuc, Xuc, Ur^Br|, Xuc, Ms^Xm, Ms^Xm, Ms^Xm
Ms, Ms, Ms, Ms, Ms, Ms, Ms, Aa^Fda, Ai, Ai, Ai^Bw/, Ai^Bw/, Ai, Aa, Aa, Ha, Ms, Ms, Ms, Ms^Xm, Ms^Xm, Ms, Ms^Xm, Ms^Xm, Xu, Xu, Urb, Urb, Urb, Urb, Urb, Urb, Urb, Urb, Urb, Urb, Urb, Rr^Pr\, Xuc, Ms^Xm, Ms^Xm, Ms^Xm
Ms, Ms, Ms, Ms, Ms, Ms, Aa^Fda, Aa^Fda, Aa, Ai^Bw/, Ai, Ai, Ms, Ms, Aa, Aa, Ms, Ms, Ms^Xm, Ms^Xm, Ms^Xm, Ms^Xm, Xu, Xu, Urb, Urb, Ql, Urb, Urb, Uu^Vud, Ql, Ql, Ql, Uu^Vud, Urb, Urb, Ql, Urb, Urb, Xu, Xu, Ms^Xm
Ms, Ms, Ms, Ms, Ms, Ms, Ms, Ms, Ai^Bw|, Ai, Ai, Ai, Ms, Ms, Aa, Ms, Ms, Ms, Ms^Xm, Ms^Xm, Ms^Xm, Xu, Hh^Vhh, Urb, Hh, Urb, Ql, Urb, Ql, Urb, Cud, Cud, Cud, Urb, Ql, Urb, Ql, Urb, Uu^Vu, Rb, Rb, Xu
Ms, Ms, Ms, Ms, Ms, Ms, Ms, Aa^Voa, Aa, Aa^Fda, Ai, Ms, Ai, Ms, Ms, Aa, Aa, Ms, Ms, Ms^Xm, Ms^Xm, Xu, Hh, Hh, Hh^Vhh, Urb, Ql, Urb, Ql, Ql, Cud, 3 Kud, Cud, Ql, Ql, Urb, Ql, Urb, Rb, Rb, Uu^Vu, Xu
Ms, Ms, Ms, Ms, Ms, Ms, Ms, Aa, Aa^Fda, Aa^Fda, Ai, Ai, Ai, Ai, Ai, Ms, Ms, Aa, Aa, Ms, Ms, Xu, Xu, Hh, Urb, Urb, Ql, Urb, Urb, Urb, Ql, Cud, Ql, Urb, Urb, Urb, Ql, Urb, Urb, Urb, Xu, Xu
Ms, Ms, Cte, Cte, Cte, Ms, Aa, Aa, Ai, Aa^Fda, Ai, Ai, Aa^Fda, Ai, Ai, Ai, Ms, Ms, Aa, Ms, Ms, Ms^Xm, Ms^Xm, Xu, Cud, Urb, Urb, Urb, Urb, Uu^Vud, Urb, Ql, Urb, Uu^Vud, Urb, Urb, Urb, Urb, Xu, Xu, Ms^Xm, Ms^Xm
Ms, Ms, Cte, Cte, 2 Kte, Aa, Aa^Fda, Aa^Fda, Aa^Fda, Ai, Ai, Ai, Aa^Fda, Aa^Fda, Aa^Fda, Ai, Ai, Ms, Aa^Vha, Aa, Ms, Ms^Xm, Aa, Ms^Xm, Aa, Urb, Cud, Urb, Urb, Urb, Uu^Vud, Urb, Uu^Vud, Urb, Urb, Urb, Xu, Xu, Ms^Xm, Ms^Xm, Ms^Xm, Ms^Xm
Ms, Ms, Ms, Cte, Ms, Ms, Ms, Aa^Fda, Aa^Fda, Ms, Ms, Aa^Fda, Aa^Fda, Aa^Fda, Aa^Fda, Ai, Ai, Ha, Ms, Aa, Aa, Aa, Ms^Xm, Aa, Ms^Xm, Ms^Xm, Ms^Xm, Xu, Xu, Urb, Urb, Ql, Urb, Urb, Xu, Xu, Ms^Xm, Ms^Xm, Ms^Xm, Ms^Xm, Ms, Ms
Aa^Fda, Ms, Ms, Ms, Ms, Ms, Aa^Voa, Ms, Aa^Fda, Aa^Fda, Aa^Fda, Aa^Fda, Aa^Fda, Aa^Fda, Aa^Fda, Ai, Ai, Ai, Ms, Aa, Ms, Ms, Ms, Ms^Xm, Ms^Xm, Ms^Xm, Ms^Xm, Ms^Xm, Ms^Xm, Xu, Xu, Urb, Xu, Xu, Ms^Xm, Ms^Xm, Ms^Xm, Ms^Xm, Ms, Ms, Ms, Ms
Aa^Fda, Aa^Fda, Aa^Fda, Ms, Aa^Fda, Ms, Aa^Fda, Aa^Fda, Ai, Aa^Voa, Ai, Ms, Ms, Ms, Ms, Ai, Ai, Ai, Ai, Aa, Aa, Ms, Ms, Ms, Ms, Ms^Xm, Ms^Xm, Ms^Xm, Ms^Xm, Ms^Xm, Ms^Xm, Xu, Ms^Xm, Ms^Xm, Ms^Xm, Ms^Xm, Ms^Xm, Ms, Ms, Ms, Ha, Ha
Aa^Fda, Aa^Fda, Aa^Fda, Aa^Fda, Aa^Fda, Aa^Fda, Ms, Ms, Ai, Ai, Ai, Ms, Ms, Ms, Ms, Ai, Ai, Ai, Ai, Ai, Ai, Aa, Ms, Ms, Ms, Ms, Ms, Ms^Xm, Ms^Xm, Ms^Xm, Ms^Xm, Ms^Xm, Ms^Xm, Ms^Xm, Ms^Xm, Ms^Xm, Ms, Ms, Ms, Ms, Ms, Ms^Xm
Aa^Fda, Aa^Fda, Aa^Fda, Aa^Fda, Aa^Fda, Aa^Fda, Ms, Ai, Ai, Ai, Ai, Ms, Ms, Ms, Ai, Ms, Ai, Ai, Ai, Ai, Ai, Ai^Bw|, Ai, Ms, Ms, Ms, Ms, Ms, Ms, Ms^Xm, Ms^Xm, Ms^Xm, Ms, Ms^Xm, Ms, Ms, Ms, Ms, Ms, Ms, Ms, Ms
Aa^Fda, Aa^Fda, Aa^Fda, Ms, Ms, Ms, Ms, Ai, Ai, Ai, Ai, Ai, Ms, Ai, Ai, Ai, Ai, Ms, Ai, Ai, Ai, Aa, Aa, Ai, Ai, Ms, Ms, Ms, Ms, Ms, Ms, Ms, Ms, Ms, Ms, Ms, Ms, Ms, Ms, Ms, Ms, Ms
Mm, Aa^Fda, Aa^Fda, Ms, Ms, Ms, Ms, Ms, Ms, Ai, Ai, Ai, Ai, Ai, Ai, Ai, Ai, Ai, Ai, Ai, Ai, Ai, Aa^Vaa, Aa, Ai, Ms, Ms, Ms, Ms, Ms, Ms, Ms, Ms, Ms, Ms, Ms, Ms, Ms, Ms, Ms, Ms, Ms
Mm, Ms, Ms, Ms, Ms, Ms, Ms, Ms, Ai, Ai, Ai, Ai, Ai, Ai, Ms, Ai, Ai, Ai, Ms, Ai, Ai, Ai, Ai, Ai^Bw|, Ai, Ai, Ha, Ai, Ms, Ms, Ms, Ms, Ms, Ms, Ms, Ms, Ms, Ms, Ms, Ms, Ms, Ms
Ms, Ms, Ms, Ms, Ms, Ms, Ms, Ms, Ai, Ms, Ai, Ai, Ai, Ai, Ai, Ai, Ai, Ai, Ai, Ai, Ms, Ha, Ha, Ai^Bw|, Ha, Ha, Ha, Ai, Ai, Ms, Ms, Ms, Ms, Ms, Ms, Ms, Ms, Ms, Ms, Ms, Ms, Ms
Ms, Ms, Ms, Aa^Fda, Aa^Fda, Aa^Fda, Aa^Fda, Aa^Fda, Ai, Ai, Ai, Ai, Ai, Ai, Ai, Ai, Ms, Ms, Ms, Ms, Ms, Ms, Ha, Ai^Bw|, Ai, Ha, Ai, Ai, Ms, Ms, Ms, Ms, Ms, Ms, Ms, Ms, Ms, Ms, Ms, Ms, Ms, Ms
Mm, Aa^Fda, Aa^Fda, Aa^Fda, Aa^Fda, Aa^Fda, Aa^Fda, Ai, Ai, Ai, Ai, Ai, Ha, Ha, Ai, Ai, Ms, Ms, Ms, Ms, Ms, Ms, Ha, Aa, Ai, Ai, Ha, Ai, Ms, Ms, Ms, Ms, Ms, Ms, Ms, Rrc^Vhca, Ms, Ms, Ms, Ms, Ms, Ms
Mm, Aa^Fda, Ms, Aa^Fda, Aa^Fda, Aa^Fda, Ai, Ai, Ha, Ha, Ha, Ai, Ai, Ai, Ai, Ms, Ms, Ms, Ms, Ms, Ms, Ha, Ha, Aa, Ai, Ai, Ha, Ha, Ms, Ms, Ms, Ms, Ms, Ms, Ms, Ms, Ms, Ms, Ms, Ms, Ms, Ms
Mm, Aa^Fda, Aa^Fda, Ms, Ms, Ai, Ai, Ha, Ai, Ms, Ai, Ha, Ai, Ha, Ai, Ha, Ha, Ms, Ms, Ms, Ha, Ha, Ha, Aa, Ha, Ha, Ha, Ha, Ms, Ms, Ms, Ms, Ms, Ms, Ms, Ms, Ms, Ms, Ms, Ms, Ms, Ms
Mm, Aa^Fda, Aa^Fda, Aa^Fda, Ms, Ms, Ai, Ai, Ai, Ai, Ai, Ai, Ha, Ai, Ha, Ai, Ha, Ha, Ms, Ha, Ha, Ha, Ha, Aa, Ha, Ha, Ha, Ha, Ha, Ms, Ms, Ms, Ms, Ms, Ms, Ms, Ms, Ms, Ms, Ms, Ms, Ms
Mm, Aa^Fda, Ms^Xm, Aa^Fda, Ms, Ms, Ms, Ai, Ai, Ai, Ai, Ai, Ai, Ai, Ha, Ai, Ai, Ha, Ai, Ha, Ha, Ha, Ha, Aa, Ha, Ha, Ha, Ha, Ms, Ms, Ms, Ms, Ms, Ms, Ms, Ms, Ms, Ms, Ms, Ms, Ms, Ms
Mm, Aa^Fda, Aa^Fda, Aa^Fda, Aa^Fda, Ms, Ms, Ms, Ms, Ai, Aa^Voa, Ai, Ai, Ha, Ha, Ha, Ha, Ai, Ai, Ai, Ha, Ha, Ha, Aa, Ha^Vhha, Ha, Ha, Ms, Ms, Ms, Ms, Ms, Ms, Ms, Ms, Ms, Ms, Ms, Ms, Ms, Ms, Ms
Mm, Aa^Fda, Aa^Fda, Aa^Fda, Ms, Ms, Ms, Ms, Ha, Ai, Ai, Ai, Ai, Ha, Ai, Ai, Ai, Ai, Ha, Ha, Ha, Ha, Ha, Aa, Ha, Ms, Ms, Ms, Ms, Ms, Ms, Ms, Ms, Ms, Ms, Ms, Ms, Ms, Ms, Ms, Ms, Ms
Mm, Aa^Fda, Aa^Fda, Aa^Fda, Ms, Ms, Ms, Ha, Ha, Ha, Ha, Ai, Ai, Ai, Ms, Ms, Ms, Ai, Ha, Ha, Ms, Ms, Ms, Aa, Ha, Ms, Ms, Ms, Ms, Ms, Ms, Ms, Ms, Ms, Ms, Ms, Ms, Ms, Ms, Ms, Ms, Ms
Mm, Aa^Fda, Aa^Fda, Aa^Fda, Ms, Ms, Ms, Ha, Ha, Ha, Ha, Ai, Ai, Ai, Ai, Ms, Ai, Ms, Ms, Ms, Ms, Ms, Ms, Aa, Ms, Ms, Ms, Ms, Ms, Ms, Ms, Ms, Ms, Ms, Ms, Ms, Ms, Ms, Ms, Ms, Ms, Ms
Mm, Aa^Fda, Ms, Ms, Ms, Ms, Ms, Ha, Ha, Ha, Ha, Ai, Ai, Ai, Ai, Ai, Ai, Ai, Ai, Ms, Ms, Ms, Aa, Aa, Ms, Ms, Ms, Ms, Ms, Ms, Ms, Ms, Ms, Ms, Ms, Ms, Ms, Ms, Ms, Ms, Ms, Ms
Aa^Fda, Aa^Fda, Aa^Fda, Ms, Ms, Ms, Ha, Ha, Ha, Ha, Ha, Ha, Ai, Ai, Ai, Ai, Ai, Ms^Xm, Ai, Aa^Vca, Ms, Ms, Aa, Ms, Ms, Ms, Ms, Ms, Ms, Ms, Ms, Ms, Ms, Ms, Ms, Ms, Ms, Ms, Ms, Ms, Ms, Ms
Ms, Ms, Ms, Aa^Fda, Aa^Fda, Aa^Fda, Ha, Ha, Ha, Ha, Ha, Ha, Ai, Ai, Ai, Ai, Ai, Ai, Ai, Ms, Ms, Ms, Aa, Ms, Ms, Ms, Ms, Ms, Ms, Ms, Ms, Ms, Ms, Ms, Ms, Ms, Ms, Ms, Ms, Ms, Ms, Ms
Ms, Ms, Ms, Ms, Ms, Aa^Fda, Aa^Fda, Ha, Aa^Fda, Ha, Ha, Ha, Ai, Ai, Ai, Ai, Ai, Ai, Ms, Ms, Ms, Ms, Ms, Aa, Aa, Ms, Ms, Ms, Ms, Ms, Ms, Ms, Ms, Ms, Ms, Ms, Ms, Ms, Ms, Ms, Ms, Ms
Ms, Ms, Ms, Ms, Ms, Ms, Aa^Fda, Aa^Fda, Aa^Fda, Aa^Fda, Aa^Fda, Ai, Ai, Ai, Ai, Ms, Ai, Ai, Ms, Ms, Ms, Ms, Ha, Ha, Ha, Aa, Aa, Ms, Ms, Ms, Ms, Ms, Ms, Ms, Ms, Ms, Ms, Ms, Ms, Ms, Ms, Ms
Ms, Ms, Ms, Ms, Ms, Aa^Fda, Aa^Fda, Aa^Fda, Aa^Fda, Aa^Fda, Ms, Ai, Ai, Ai, Ms, Ai, Ai, Ai, Ww, Ms, Ms, Ms, Ha, Ha, Ms, Ha, Aa, Ha, Ha, Ha, Ms, Ms, Ms, Ms, Ms, Ms, Ms, Ms, Ms, Ms, Ms, Ms
Ms, Ms, Ms, Ms, Ms, Ms, Ms, Ms, Aa^Vha, Aa^Fda, Aa^Fda, Ms, Ms, Ms, Ms, Ms, Ai, Ai, Ai, Ms, Ms, Ms, Ms, Ms, Ms, Ms, Ms, Cea, Cea, Ha, Ha, Ms, Ha, Ms, Ms, Ms, Ms, Ms, Ms, Ms, Ms, Ms
Ms, Ms, Ms, Ms, Ms, Ms, Ms, Ms, Ms, Ms, Ms, Ms, Ms, Ms, Ms, Ms, Ai, Ms, Ms, Ms, Ms, Ms, Ms, Ms, Ms, Ms, Ms, Cea, 1 Kea, Aa^Vla, Ms, Ha, Ha, Ms, Ms, Ms, Ms, Ms, Ms, Ms, Ms, Ms
Ms^Xm, Ms, Ms, Ms, Ai, Ai, Ai, Ms, Ms, Ms, Ms, Ms, Ms, Ms, Ms, Ms, Ai, Ai, Ms, Ms, Ms, Ms, Ms, Ms, Ms, Ms, Ms, Ms, Ms, Ms, Ms, Ms, Ms, Ms, Ms, Ms, Ms, Ms, Ms, Ms, Ms, Ms
Ms^Xm, Ms^Xm, Ms, Ms, Ai, Ai, Ai, Ai, Ai, Ms, Ms, Ms, Ms, Ms, Ms, Ms, Ai, Ai, Ms, Ms, Ms, Ms, Ms, Ms, Ms, Ms, Ms, Ms, Ms, Ms, Ms, Ms, Ms, Ms, Ms, Ms, Ms, Ms, Ms, Ms, Ms, Ms
Ms^Xm, Ms^Xm, Ms, Ms, Ms, Ai, Ai, Ai, Ai, Ai, Ms, Ms, Ms, Ms, Ms, Ms, Ai, Ms, Ms, Ms, Ms, Ms, Ms, Ms, Ms, Ms, Ms, Ms, Ms, Ms, Ms, Ms, Ms, Ms, Ms, Ms, Ms, Ms, Ms, Ms, Ms, Ms
Ms^Xm, Ms^Xm, Ms^Xm, Ms, Ms, Ai, Ai, Ms, Ai, Ms, Ms, Ms, Ai, Ms, Ai, Ai, Ms, Ms, Ms, Ms, Ms, Ms, Ms, Ms, Ms, Ms, Ms, Ms, Ms, Ms, Ms, Ms, Ms, Ms, Ms, Ms, Ms, Ms, Ms, Ms, Ms, Ms
Ms^Xm, Ms^Xm, Ms^Xm, Ms^Xm, Ms, Ai, Ai, Ai, Ai, Ai, Ai, Ai, Ai, Ai, Ai, Ai, Ms^Xm, Ms^Xm, Ms^Xm, Ms^Xm, Ms^Xm, Ms^Xm, Ms^Xm, Ms^Xm, Ms^Xm, Ms^Xm, Ms^Xm, Ms^Xm, Ms^Xm, Ms^Xm, Ms^Xm, Ms^Xm, Ms^Xm, Ms^Xm, Ms^Xm, Ms^Xm, Ms^Xm, Ms^Xm, Ms^Xm, Ms^Xm, Ms^Xm, Ms