Xu, Xu, Xu, Xu, Xuc, Urb^Br|, Xom, Xu, Xu, Xu, Xu, Xu, Xu, Xu, Xu, Uh, Xu
Xu, Ur^Ii, Xu, Xu, Xuc, Urb^Br|, Xuc, Xu, Uu^Emf, Xu, Cer, Xu, Ker, Xu, Xu, Xu, Xu
Xu, Xu, Uu, Uu, Xuc, Qxu^Bp|, Xuc, Uu, Uu, Uu, Uu, Cer, Cer, Cer, Uh, Uh, Xu
Xu, Xu, Uu, Uu, Uu, Qxu^Bp|, Xuc, Uu, Uu, Uu, Uu^Em, Uue, Uue, Uu, Uh, Uh, Xu
Xu, Xu, Uu, Uu, Xuc, Urb^Br|, Xuc, Uu, Uu, Uu^Em, Uu, Uue, Uh, Uh, Uh, Uh, Xu
Xu, Xu, Uu^Vu, Uu, Xuc, Urb^Br|, Xuc, Uu, Uu^Em, Uu^Em, Uue, Uue, Uu^Vud, Uh, Uh, Uh, Xu
Xu, Xu, Uh, Uu, Xuc, Urb^Br|, Xuc, Uu, Uue, Uue, Uu, Uu, Uh, Uh, Uh, Uh, Xu
Xu, Xu, Uh, Uu, Xuc, Urb^Br|, Uue, Uue, Uu, Uu^Em, Uu^Em, Uu, Qxu, Uh, Uh, Uh, Xu
Xu, Uh, Uu, Uu, Xuc, Urb^Br|, Xuc, Uu, Uu, Uu, Uu, Qxu, Uu, Uu, Uu^Vud, Qxu, Xu
Xu, Xu, Uu, Uu, Xuc, Urb^Br|, Urb^Br\, Xuc, Xuc, Uu, Uu, Uu^Em, Uu^Em, Uu, Uu, Qxu, Xu
Xu, Xu, Uu, Uu, Uu, Xuc, Xuc, Urb^Br\, Urb^Br\, Xuc, Xuc, Uu, Uu, Uu^Em, Uu, Uu, Xu
Xu, Uu, Uu^Em, Uu^Em, Uu, Uu, Uu, Xuc, Xuc, Urb^Br\, Urb^Br\, Xuc, Xuc, Uu, Uu, Uu, Xu
Xu, Xu, Uu^Em, Uu^Em, Uu^Em, Uu, Uu^Em, Uu, Uu, Xuc, Xuc, Urb^Br\, Urb^Br\, Xuc, Uh, Uu, Xu
Xu, Xu, Uu, Uu^Em, Uu, Uu^Em, Uu^Em, Uu^Em, Uu, Uu, Uu, Xuc, Urb^Br|, Xuc, Uh, Uh, Xu
Xu, Xu, Uu, Uu^Vud, Uh, Uh, Uh, Uu, Uu, Uu, Uu, Xuc, Urb^Br|, Xuc, Uh, Uh, Xu
Xu, Xu, Uh, Uh, Uh, Uh, Uh, Uh, Uh, Uu, Uu, Xuc, Urb^Br|, Xuc, Uu, Uu^Uf, Xu
Xu, Xu, Uh, Uh, Uh, Uh, Uh, Uh, Uh, Uu, Uu, Xuc, Urb^Br|, Xuc, Uu, Uu, Xu
Xu, Uh, Uh, Uh, Uh, Uh, Uh, Uh, Uh, Uu, Uu, Xuc, Urb^Br|, Xuc, Uu, Uu, Xu
Xu, Uh, Uh, Uu, Uu, Uh, Uh, Uh, Uu, Uu, Uu, Xuc, Urb^Br|, Xuc, Uu, Uu, Xu
Xu, Xu, Uu^Es, Uu, Uu^Es, Uu, Uu^Es, Uu, Uu, Uu, Uu, Xuc, Urb^Br|, Xuc, Uh, Uu, Xu
Xu, Uu^Uf, Uu, Uu^Es, Uu, Uu, Uu, Uu^Es, Uu^Es, Uu, Uu, Xuc, Urb^Br|, Xuc, Uh, Uu^Vud, Xu
Xu, Uu, Uu, Uu, Uu, Uu, Qxu, Uu, Qxu, Uu^Es, Qxu, Xuc, Urb^Br|, Xuc, Uu, Uh, Xu
Xu, Xu, Xu, Xu, Uu, Qxu, Uu, Uu, Uu^Es, Qxu, Uu, Xuc, Urb^Br|, Xuc, Uu, Uh, Xu
Xu, Xu, Uu, Xu, Uu, Uu, Uu, Uu, Uu^Em, Uu, Uu, Xuc, Urb^Br|, Xuc, Uu, Uu, Xu
Xu, Uu, Uu, Uu, Uh, Uu, Uu, Uu, Uu, Uu, Uu, Xuc, Urb^Br|, Xuc, Uu, Uu, Xu
Xu, Uu, Uh, Uh, Uh, Uh, Uh, Uu, Uu, Uu^Em, Uu, Xuc, Urb^Br|, Xuc, Uu, Uu, Xu
Xu, Xu, Uh, Uh, Uh, Uh, Uh, Uu^Vud, Uu, Uu^Em, Uu, Xuc, Urb^Br|, Xuc, Uh, Uu, Xu
Xu, Xu, Uh, Uh, Uh, Uh, Uh, Uh, Uu, Uu, Uu, Xuc, Urb^Br|, Xuc, Uh, Uu, Xu
Xu, Xu, Uu, Uh, Uu, Uh, Uu, Uh, Uu, Uu, Xuc, Xuc, Urb^Br|, Xuc, Uu, Uh, Xu
Xu, Uu, Uu, Uu^Em, Uu^Em, Uu, Uu, Uu, Xuc, Xuc, Urb^Br/, Urb^Br/, Xuc, Xuc, Uu, Uh, Xu
Xu, Uu^Eb, Uu, Uu^Edb, Uu, Uu^Edt, Xuc, Xuc, Urb^Dr, Qxu, Xuc, Xuc, Uu, Uu, Uu, Uu, Xu
Xu, Uu^Vu, Ur, Ur, Xuc, Rr^Pr/o, Urb^Br/, Urb^Br/, Xuc, Xuc, Uu, Uu, Uu, Uu, Uu, Uu, Xu
Xu, Xu, Uu, Uu, Xuc, Urb^Br/, Xuc, Xuc, Uu, Uu, Uu, Uu, Uu, Uu, Uu, Uu, Xu
Xu, Xu, Uu, Uu, Xuc, Urb^Br|, Xuc, Uu, Uu, Uu, Uu, Uu, Uu, Uu, Uu, Uu, Xu
Xu, Xu, Uu, Uu, Xuc, Urb^Br|, Xuc, Uu, Uu, Uu, Uu, Uu, Uu, Uu, Uu, Uu, Xu
Xu, Uu, Uu, Uu, Xuc, Urb^Br|, Xuc, Qxu, Qxu, Uu, Uu, Uu, Uu, Qxu, Qxu, Qxu, Xu
Xu, Uu^Em, Uu, Uu^Em, Xuc, Urb^Br|, Rr^Pr/o, Uu, Uu, Uu, Uu, Uu, Uu, Uu, Uu, Uu, Xu
Xu, Uu, Uu^Em, Uu, Xuc, Urb^Br|, Xuc, Ur, Ur, Uu, Uu, Uu, Uu, Uu, Uu, Uu, Xu
Xu, Uu, Uu, Uu, Xuc, Urb^Br|, Xuc, Uu^Vud, Uu^Ecf, Ur, Ur, Uu, Uu, Uu, Uu, Uu, Xu
Xu, Uu, Uu, Uu^Em, Xuc, Urb^Br|, Xuc, Uu, Uu, Uu, Uu, Ur, Ur, Uu, Uu, Uu, Xu
Xu, Uu, Uu, Uu, Xuc, Urb^Br|, Xuc, Uu, Uu, Uu, Uu, Uu, Ur, Ur, Uu, Uu, Xu
Xu, Uu, Uu, Uu, Xuc, Urb^Br|, Urb^Br\, Xuc, Xuc, Uu, Uu, Uu, Uu, Ur, Uu, Uu, Xu
Xu, Uu^Em, Uu, Uu, Uu, Xuc, Rr^Pr\o, Urb^Br\, Xuc, Uu, Uu, Uu, Uu, Ur, Ur^Efs, Uu, Xu
Xu, Uu, Uu, Uu, Ur, Ur, Xuc, Urb^Br|, Xuc, Uu, Uh, Uh, Uh, Uu, Uh, Uu^Vud, Xu
Xu, Uu, Ur, Ur, Ce, Ce, Xuc, Urb^Br|, Xuc, Uh, Uh, Uh, Uh, Uh, Uh, Uh, Xu
Xu, Uu^Emf, Uu^Vud, Uu^Ebn, Ce, 1 Ke, Xuc, Urb^Br|, Xuc, Uh, Xu, Xu, Xu, Uh, Xu, Uh, Xu
Xu, Xu, Xu, Xu, Xu, Xu, Xom, Urb^Br|, Xuc, Xu, Xu, Xu, Xu, Xu, Xu, Xu, Xu